5 5 5 0 5 5 5 6 5 0 4 4 4 5
0 0 0 0 0 0 0 0 0 0 0 0 0 0
4 4 5 5 6 6 0 0 8 7 6 5 4 3
4 0 0 0 0 0 0 0 0 0 0 0 0 0
3 0 3 3 4 0 4 4 5 0 6 0 0 4